2 0 0 0 -1 0 0 1 0 -1 4 4 
2 0 0 1 6 1 4 1 0 -1 4 4 
2 0 0 2 5 1 1 1 0 -1 4 4 
2 1 0 2 5 1 1 1 0 -1 4 4 
2 0 0 2 5 1 2 1 0 11 4 4 
2 1 0 2 5 2 1 1 0 11 4 4 
2 0 0 2 5 1 1 1 0 11 2 3 
2 1 0 2 5 3 0 1 0 11 2 3 
2 0 0 2 5 3 0 1 0 11 1 3 
2 0 0 3 4 4 1 1 0 11 1 3 
2 0 0 4 3 4 2 1 0 11 1 4 
2 1 0 4 3 3 4 1 0 11 1 4 
2 1 0 4 3 3 4 1 1 10 0 4 
2 0 0 4 3 3 4 1 1 10 0 4 
2 1 0 4 3 3 0 1 1 10 0 4 
2 1 0 4 3 3 0 1 2 9 2 3 
2 0 0 4 3 3 4 1 2 9 2 3 
2 0 0 5 2 2 4 1 2 9 2 3 