12 7 11 10 6 3 8 4 9 0 5 2 1 
12 11 10 6 3 8 4 9 0 5 2 1 
12 11 10 6 3 8 4 9 0 5 2 1 
12 11 10 6 3 8 4 9 0 5 2 1 
12 10 6 3 8 4 9 0 5 2 1 
12 10 6 3 8 4 9 0 5 2 1 
12 10 6 3 8 4 9 0 5 2 1 
12 10 6 3 8 4 9 0 5 2 1 
12 10 6 3 8 4 9 0 5 2 1 
12 10 6 3 8 4 9 0 5 2 1 
12 10 6 3 8 4 9 0 5 2 1 
12 10 6 3 8 4 9 0 5 2 1 
12 10 6 3 8 4 9 0 5 2 1 
12 10 6 3 8 4 9 0 5 2 1 
12 10 6 3 8 4 9 0 5 2 1 
12 10 6 3 8 4 9 0 5 2 1 
12 10 6 3 8 4 9 0 5 2 1 
12 10 6 3 8 4 9 0 5 2 1 